a.d	a.d.
a.m	a.m.
abbies	abbeys
abhored	abhorred
abilitie	ability
aboute	about
abouts	about
abridg	abridge
absorpt	absorbed
academick	academic
academie	academy
accessorize	accessorise
accomodation	accommodation
accompanie	accompany
accompt	account
accompts	accounts
accordinglie	accordingly
accouterments	accoutrements
accrueing	accruing
accurst	accursed
achs	aches
acknowlege	acknowledge
acknowleged	acknowledged
acknowlegement	acknowledgement
acknowlegements	acknowledgements
acknowleges	acknowledges
acknowleging	acknowledging
acount	account
adde	add
addrest	addressed
adjoyning	adjoining
administred	administered
administring	administering
adown	down
adulterie	adultery
advantagious	advantageous
adventrous	adventurous
adviseable	advisable
aegypt	egypt
aegyptian	egyptian
aegyptians	egyptians
aenigmatical	enigmatical
aerie	eyrie
aerogram	aerogramme
aerograms	aerogrammes
aeternal	eternal
aetherial	aethereal
aethiopia	ethiopia
affaire	affair
affaires	affairs
affraid	afraid
africk	africa
africk's	africa's
afte	aft
againe	again
agen	again
aging	ageing
agreable	agreeable
aile	ail
ailes	ails
aimable	amiable
aire	air
ake	ache
aking	aching
alarum	alarm
alass	alas
alchymist	alchemist
alchymy	alchemy
allarm	alarm
allarmed	alarmed
allarming	alarming
allarms	alarms
alle	all
alledge	allege
alledged	alleged
alledges	alleges
alledging	alleging
alloted	allotted
allum	alum
almanack	almanac
almanack	almanac
almanacks	almanacs
almightie	almighty
almon	almond
alpes	alps
alps	alps
alreadie	already
altho	although
aluminum	aluminium
alway	always
amboyna	amboina
amitie	amity
amphitheater	amphitheatre
amphitheaters	amphitheatres
amplifie	amplify
analagous	analogous
analog	analogue
analogie	analogy
analogs	analogues
analyze	analyse
analyzed	analysed
analyzes	analyses
analyzing	analysing
anatomie	anatomy
ancle	ankle
ancles	ankles
anemia	anaemia
anemic	anaemic
anesthesia	anaesthesia
anesthetic	anaesthetic
anesthetics	anaesthetics
anesthetist	anaesthetist
anesthetists	anaesthetists
angelick	angelic
angrie	angry
anie	any
annales	annals
antick	antic
anticks	antics
antient	ancient
antiently	anciently
antients	ancients
antiqua	antiquam
apoftolick	apostolic
apologie	apology
apostacy	apostasy
apostolick	apostolic
appall	appal
appalls	appals
appartment	apartment
appeare	appear
applyed	applied
arabick	arabic
arabie	araby
arbor	arbour
arbors	arbours
archbishoprick	archbishopric
archeological	archaeological
archeologically	archaeologically
archeologie	archaeology
archeologist	archaeologist
archeologists	archaeologists
archeology	archaeology
ardor	ardour
arfenick	arsenic
aristocratick	aristocratic
aristocratie	aristocracy
arithmetick	arithmetic
arme	arm
armes	arms
armie	army
armor	armour
armored	armoured
armorer	armourer
armorers	armourers
armories	armouries
armory	armoury
aromatick	aromatic
arsenick	arsenic
arte	art
artes	arts
artifact	artefact
artifacts	artefacts
artillerie	artillery
artizan	artisan
artizans	artisans
asiatick	asiatic
aske	ask
askt	asked
assemblie	assembly
assemblys	assemblies
asswage	assuage
astronomie	astronomy
atchieve	achieve
atchieved	achieved
atchievement	achievement
atchievements	achievements
atchieves	achieves
atchieving	achieving
atlantick	atlantic
atrophie	atrophy
attick	attic
attone	atone
attonement	atonement
attornies	attorneys
attrocious	atrocious
aucthoritie	authority
auctoritie	authority
aukward	awkward
aukwardly	awkwardly
aukwardness	awkwardness
auld	old
auncient	ancient
aunswer	answer
aunswere	answer
aunswered	answered
auntient	ancient
authentick	authentic
authour	author
awaie	away
aweful	awful
awefully	awfully
ax	axe
ayre	air
ayres	airs
aÃ«rial	aerial
b.c	b.c.
babie	baby
babling	babbling
backpedaled	backpedalled
backpedaling	backpedalling
bagdad	baghdad
bagdat	baghdad
baie	bay
baliol	balliol
balk	baulk
balked	baulked
balking	baulking
balks	baulks
ballance	balance
ballanced	balanced
ballances	balances
ballancing	balancing
baltick	baltic
banister	bannister
banisters	bannisters
banquetting	banqueting
barbadoes	barbados
baronie	barony
barque	bark
barr	bar
barre	bar
bason	basin
basse	base
bast	baste
batchelor	bachelor
batchelors	bachelors
battel	battle
batteled	battled
battels	battles
batterie	battery
battleax	battleaxe
bawble	bauble
bayes	bays
bayle	bail
bc	b.c.
beare	bear
beate	beat
beatifick	beatific
beautifie	beautify
becase	because
bedeviled	bedevilled
bedeviling	bedevilling
beene	been
befal	befall
befals	befalls
befel	befell
befor	before
begining	beginning
behavior	behaviour
behavioral	behavioural
behaviorism	behaviourism
behaviorist	behaviourist
behaviorists	behaviourists
behaviors	behaviours
behoove	behove
behooved	behoved
behooves	behoves
bejeweled	bejewelled
belabor	belabour
belabored	belaboured
belaboring	belabouring
belabors	belabours
beldam	beldame
belive	believe
bely	belie
belye	belie
bended	bent
beneficiarie	beneficiary
benefitted	benefited
bequeathe	bequeath
bequeathes	bequeaths
bere	bear
bespake	bespoke
bett	bet
betts	bets
betweene	between
betwen	between
beveled	bevelled
bever	beaver
bevies	bevvies
bevy	bevvy
biased	biassed
biasing	biassing
bibliographie	bibliography
bifhoprick	bishopric
biflioprick	bishopric
bigotted	bigoted
binging	bingeing
biographie	biography
bishoprick	bishopric
bishopricks	bishoprics
bisket	biscuit
blacke	black
blesse	bless
blest	blessed
blith	blithe
bloodie	bloody
blustring	blustering
blyth	blithe
blythe	blithe
boadicia	boadicea
bodie	body
boistrous	boisterous
boke	book
booke	book
bord	board
borne	born
bosome	bosom
bougainvillea	bougainvillaea
bougainvilleas	bougainvillaeas
bourdeaux	bordeaux
bourne	bourn
bove	above
bowes	bows
bowles	bowls
bragg	brag
bras	brass
breathalyze	breathalyse
breathalyzed	breathalysed
breathalyzer	breathalyser
breathalyzers	breathalysers
breathalyzes	breathalyses
breathalyzing	breathalysing
brest	breast
briars	briers
britains	britain
britannick	britannic
britany	brittany
brooke	brook
brookes	brooks
broome	broom
brough	borough
browne	brown
buffoonry	buffoonery
bur	burr
burgoyne	bourgogne
burne	burn
burthen	burden
burthened	burdened
burthening	burdened
burthens	burdens
burthensome	burdensome
buryed	buried
busie	busy
busses	buses
bussing	busing
byass	bias
cabbin	cabin
caelestial	celestial
caled	called
caliber	calibre
calibers	calibres
calisthenics	callisthenics
calle	call
callicoes	calicoes
calliper	caliper
callipers	cawliiclipzlipers
cameleon	chameleon
camelion	chameleon
campbel	campbell
cancelation	cancellation
cancelations	cancellations
canceled	cancelled
canceling	cancelling
candor	candour
canvass	canvas
capacitie	capacity
captivitie	captivity
carefull	careful
carefullie	carefully
carelesly	carelessly
carelesness	carelessness
caroled	carolled
caroling	carolling
carrick	carrack
carrol	carol
carrols	carols
carryed	carried
carte	cart
cartes	carts
cary	carry
castel	castle
castell	castle
castile	castille
catalog	catalogue
cataloged	catalogued
cataloging	cataloguing
catalogs	catalogues
catalyze	catalyse
catalyzed	catalysed
catalyzes	catalyses
catalyzing	catalysing
catholick	catholic
catholicks	catholics
catholie	catholic
cattel	cattle
caviled	cavilled
caviling	cavilling
ceconomy	economy
celle	cell
center	centre
centered	centred
centerfold	centrefold
centerfolds	centrefolds
centerpiece	centrepiece
centerpieces	centrepieces
centers	centres
centigram	centigramme
centigrams	centigrammes
centiliter	centilitre
centiliters	centilitres
centimeter	centimetre
centimeters	centimetres
centinel	sentinel
centinels	sentinels
ceremonie	ceremony
certaine	certain
certaintie	certainty
certifie	certify
cesarean	caesarean
cesareans	caesareans
chace	chase
chaced	chased
chaces	chases
chacing	chasing
chambre	chamber
champaigne	champagne
chancellerie	chancellery
chancellory	chancellery
chancellour	chancellor
chanel	channel
channeled	channelled
channeling	channelling
chapelle	chapel
chappel	chapel
chappels	chapels
characteriftick	characteristic
characteristick	characteristic
characteristicks	characteristics
charitie	charity
chastly	chastely
chaunt	chant
chaunted	chanted
chaunting	chanting
chaunts	chants
chear	cheer
cheared	cheered
chearful	cheerful
chearfully	cheerfully
chearfulness	cheerfulness
chearing	cheering
chearless	cheerless
chears	cheers
checkbook	chequebook
checkbooks	chequebooks
checkered	chequered
chere	cheer
chesnut	chestnut
chesnuts	chestnuts
chiefe	chief
chieflie	chiefly
chili	chilli
chilness	chillness
chimera	chimaera
chimeras	chimaeras
chimnies	chimneys
chiseled	chiselled
chiseling	chiselling
chissels	chisels
choak	choke
choaked	choked
choaking	choking
choaks	chokes
cholerick	choleric
cholick	colic
chorusses	choruses
chouse	choose
choused	choosed
christe	christ
chronologie	chronology
chrystal	crystal
churche	church
chuse	choose
chuses	chooses
chusing	choosing
chymic	chemic
chymical	chemical
chymist	chemist
chymistry	chemistry
chymists	chemists
cieling	ceiling
cielings	ceilings
cipher	cypher
ciphers	cyphers
citie	city
cittie	city
civily	civilly
claffick	classic
clamor	clamour
clamored	clamoured
clamoring	clamouring
clamors	clamours
clangor	clangour
clapt	clapped
clarinetist	clarinettist
clarinetists	clarinettists
classe	class
classick	classic
classicks	classics
clemencie	clemency
clerc	clerk
clergie	clergy
clerke	clerk
clipt	clipped
cloath	cloth
cloathed	clothed
cloathes	clothes
cloathing	clothing
cloaths	clothes
cloke	cloak
closetted	closeted
cloths	clothes
cloyster	cloister
cloysters	cloisters
cobler	cobbler
cobler's	cobbler's
coblers	cobblers
cocoanut	coconut
coelestial	celestial
colledge	college
colledges	colleges
collegue	colleague
collegues	colleagues
collonel	colonel
color	colour
colorant	colourant
colorants	colourants
colored	coloured
coloreds	coloureds
colorful	colourful
colorfully	colourfully
coloring	colouring
colorless	colourless
colors	colours
combate	combat
combe	comb
comber	cumber
comedie	comedy
comeing	coming
comick	comic
commited	committed
communitie	community
compagnie	company
companie	company
compleat	complete
compleated	completed
compleating	completing
compleatly	completely
compleats	completes
complection	complexion
complement	compliment
complements	compliments
complyed	complied
concil	council
condescention	condescension
confederacie	confederacy
confered	conferred
confest	confessed
confidante	confidant
confiderabie	considerable
confiderable	considerable
conformitie	conformity
confpiracie	conspiracy
consederacy	confederacy
consess	confess
considence	confidence
consined	consigned
conspiracie	conspiracy
consule	consul
consusion	confusion
continuallie	continually
contrarie	contrary
contrie	country
controll	control
controul	control
controuled	controlled
controuling	controlling
controuls	controls
controverfie	controversy
controversie	controversy
conveniencies	conveniences
copie	copy
coquets	coquettes
corde	cord
corke	cork
corne	corn
cornwal	cornwall
correfpondencie	correspondence
correspondencie	correspondency
corse	corpse
cote	coat
cotemporaries	contemporaries
cotes	coats
coud	could
councellor	counsellor
councellors	counsellors
councilor	councillor
councilors	councillors
counseled	counselled
counseling	counselling
counselor	counsellor
counselors	counsellors
countie	county
countrey	country
countreys	countries
countrys	countries
couragious	courageous
courte	court
courtesie	courtesy
courtezan	courtesan
cozier	cosier
cozies	cosies
coziest	cosiest
cozily	cosily
coziness	cosiness
cozy	cosy
craftie	crafty
craggs	crags
creat	create
crenelated	crenellated
crewe	crew
crie	cry
critick	critic
critick's	critic's
criticks	critics
cromwel	cromwell
cropt	cropped
crosse	cross
crost	crossed
croud	crowd
croud	crowd
crouded	crowded
crouding	crowding
crouds	crowds
crowne	crown
crueler	crueller
cruelest	cruellest
cryed	cried
cryer	crier
crys	cries
cuckow	cuckoo
cudgeled	cudgelled
cudgeling	cudgelling
currente	current
curst	cursed
curtesies	courtesies
curtesy	courtesy
curtsey	curtsy
custodie	custody
custome	custom
cutts	cuts
cynick	cynic
d.d	d.d.
daemon	demon
daemonic	demonic
daemons	demons
daie	day
daies	days
dailie	daily
daines	deigns
damme	damn
dandie	dandy
darkned	darkened
darknesse	darkness
daunce	dance
dawes	daws
daye	day
dayes	days
dayly	daily
dazle	dazzle
dazled	dazzled
dazling	dazzling
deane	dean
deanry	deanery
deare	dear
decipher	decypher
deciphered	decyphered
deciphering	decyphering
deciphers	decyphers
deckt	decked
decrepid	decrepit
ded	dead
defense	defence
defenseless	defenceless
defenses	defences
defie	defy
deformitie	deformity
defpotick	despotic
dele	deal
demande	demand
demeanor	demeanour
denie	deny
dente	dent
denyed	denied
deposite	deposit
deprest	depressed
deputie	deputy
dere	dear
desart	desert
desarts	deserts
desend	descend
desended	descended
desireable	desirable
despatch	dispatch
despatch	dispatch
despatched	dispatched
despatches	dispatches
despatching	dispatching
despight	despite
despotick	despotic
det	debt
develope	develop
developement	development
dialed	dialled
dialing	dialling
dialog	dialogue
dialogs	dialogues
diarrhea	diarrhoea
difcourie	discovery
difficultie	difficulty
digges	digs
digna	dignam
dignitie	dignity
diligentlie	diligently
diocess	diocese
dipt	dipped
directlie	directly
disburthened	disburdened
discernable	discernible
discolor	discolour
discolored	discoloured
discoloring	discolouring
discolors	discolours
discoverie	discovery
disemboweled	disembowelled
disemboweling	disembowelling
disfavor	disfavour
disheveled	dishevelled
dishonor	dishonour
dishonorable	dishonourable
dishonorably	dishonourably
dishonored	dishonoured
dishonoring	dishonouring
dishonors	dishonours
disk	disc
disks	discs
dismist	dismissed
dispair	despair
dispell	dispel
dispence	dispense
disperst	dispersed
dispossest	dispossessed
dissention	dissension
dissentions	dissensions
disswade	dissuade
distil	distill
distils	distills
distrest	distressed
divers	diverse
diversitie	diversity
divinitie	divinity
doat	dote
doated	doted
doating	doting
doats	dotes
doest	dost
doggrel	doggerel
dolor	dolour
domeflick	domestic
domeftick	domestic
domestick	domestic
domesticks	domestics
doo	do
dore	door
dorick	doric
doute	doubt
downe	down
downes	downs
downfal	downfall
draft	draught
draftboard	draughtboard
draftboards	draughtboards
draftier	draughtier
draftiest	draughtiest
draftsman	draughtsman
draftsmanship	draughtsmanship
draftsmen	draughtsmen
draftswoman	draughtswoman
draftswomen	draughtswomen
drafty	draughty
dramatick	dramatic
dreamt	dreamed
drest	dressed
driveled	drivelled
driveling	drivelling
dropt	dropped
drowzy	drowsy
dryed	dried
dryly	drily
dueled	duelled
dueling	duelling
duely	duly
duett	duet
dulness	dullness
dunghil	dunghill
dutchess	duchess
dutchesses	duchesses
dutchy	duchy
dwelt	dwelled
dyet	diet
dykes	dikes
e.g	e.g.
eafie	easy
eare	ear
earle	earl
earnestlie	earnestly
easie	easy
easilie	easily
eccho	echo
ecchoed	echoed
ecchoes	echos
ecchoing	echoing
ecchos	echoes
ecclesiastick	ecclesiastic
ecclesiasticks	ecclesiastics
ecclestiastick	ecclesiastic
economie	economy
ecstacy	ecstasy
edema	edoema
effectualie	effectually
effigie	effigy
elastick	elastic
elles	else
ellis	else
ells	else
els	else
embarassed	embarrassed
embarassment	embarrassment
embarras	embarrass
embarrasment	embarrassment
embassador	ambassador
embassadors	ambassadors
embattel	embattle
embatteled	embattled
embrue	imbrue
embrued	imbrued
embue	imbue
embued	imbued
embuing	imbuing
emperour	emperor
emploie	employ
emptie	empty
enameled	enamelled
enameling	enamelling
enamored	enamoured
encline	incline
enclined	inclined
enclines	inclines
enclining	inclining
encountred	encountered
encountring	encountering
encrease	increase
encreased	increased
encreases	increases
encreasing	increasing
encyclopedia	encyclopaedia
encyclopedias	encyclopaedias
encyclopedic	encyclopaedic
ende	end
endeavor	endeavour
endeavored	endeavoured
endeavoring	endeavouring
endeavors	endeavours
endite	indite
endited	indited
enditing	inditing
eneas	aeneas
enemie	enemy
energetick	energetic
energie	energy
enflame	inflame
enflamed	inflamed
engulph	engulf
engulphed	engulfed
enimies	enemies
enjoyn	enjoin
enjoyned	enjoined
enjoyning	enjoining
enjoyns	enjoins
enlightned	enlightened
ennemys	enemies
enoble	ennoble
enobled	ennobled
enow	enough
enquire	inquire
enquired	inquired
enquiries	inquiries
enquiring	inquiring
enquiry	inquiry
enroll	enrol
enrolls	enrols
ensured	insured
enterprize	enterprise
enthrall	enthral
enthralls	enthrals
enthusiastick	enthusiastic
entituled	entitled
entreats	intreats
entred	entered
entrie	entry
entring	entering
enure	inure
envie	envy
envyed	envied
enwrapt	enwrapped
eolian	aeolian
eolus	aeolus
eon	aeon
eons	aeons
epaulet	epaulette
epaulets	epaulettes
epicenter	epicentre
epicenters	epicentres
epick	epic
epilog	epilogue
epilogs	epilogues
equipt	equipped
erazed	erased
erle	earl
ermin	ermine
errour	error
errours	errors
ese	ease
esophagus	oesophagus
esophaguses	oesophaguses
especiallie	especially
esthete	aesthete
esthetes	aesthetes
esthetic	aesthetic
esthetically	aesthetically
esthetics	aesthetics
estrogen	oestrogen
eternize	eternise
ether	aether
etherial	aethereal
ethicks	ethics
etiology	aetiology
europ	europe
everie	every
examin	examine
excell	excel
excellencie	excellency
excells	excels
excentric	eccentric
exotick	exotic
expell	expel
expence	expense
expences	expenses
explicite	explicit
expresly	expressly
expresse	express
exprest	expressed
extacies	ecstasies
extacy	ecstasy
extasie	ecstasy
extasies	ecstasies
extasy	ecstasy
extatic	ecstatic
extraordinarie	extraordinary
extream	extreme
extreamest	extremest
extreamly	extremely
extreams	extremes
extremitie	extremity
extrinsick	extrinsic
eyeing	eying
f.r.s	f.r.s.
f.s.a	f.s.a.
fabrick	fabric
fabricks	fabrics
facilitie	facility
factorie	factory
faeries	fairies
faery	fairy
faire	fair
faithfull	faithful
faithfullie	faithfully
falselie	falsely
falshood	falsehood
falshood's	falsehood's
falshoods	falsehoods
falsifie	falsify
falsly	falsely
familie	family
famyly	family
fanatick	fanatic
fanaticks	fanatics
fancie	fancy
fancys	fancies
fansied	fancied
fansy	fancy
fantasie	fantasy
fantastick	fantastic
farewel	farewell
farr	far
farre	far
fastned	fastened
fatiffie	satisfy
fatisfie	satisfy
faulter	falter
faultered	faltered
faultering	faltering
faulters	falters
faultie	faulty
favor	favour
favorable	favourable
favorably	favourably
favored	favoured
favoring	favouring
favorite	favourite
favorites	favourites
favoritism	favouritism
favors	favours
favourablie	favourably
fcholaftick	scholastic
fcientifick	scientific
feare	fear
feaver	fever
fecal	faecal
feces	faeces
felonie	felony
fervor	fervour
fetal	foetal
fetid	foetid
fetus	foetus
fetuses	foetuses
fewel	fuel
fiber	fibre
fiberglass	fibreglass
fibers	fibres
fidelitie	fidelity
fidler	fiddler
fidlers	fiddlers
filet	fillet
fileted	filleted
fileting	filleting
filets	fillets
filthie	filthy
fimplicitie	simplicity
finde	find
fishes	fish
fitt	fit
fixt	fixed
flaggon	flagon
flatterie	flattery
flavor	flavour
flavored	flavoured
flavoring	flavouring
flavorings	flavourings
flavorless	flavourless
flavors	flavours
flavorsome	flavoursome
flie	fly
flimzy	flimsy
flowrie	flowery
flowry	flowery
flutist	flautist
flutists	flautists
flye	fly
flys	flies
foggie	foggy
folkes	folks
foote	foot
forbad	forbade
forborne	forborn
forensick	forensic
foretel	foretell
foretels	foretells
foreward	forward
forme	form
formerlie	formerly
forreign	foreign
forrest	forest
forrester	forester
fortifie	fortify
fossile	fossil
foule	foul
foulis	fowls
fourty	forty
foy	foi
fpanifh	spanish
fpeciallie	specially
fpecifick	specific
fpeedie	speedy
frailtie	frailty
francfort	frankfurt
francklin	franklin
frankfort	frankfurt
frantick	frantic
fraternitie	fraternity
fraude	fraud
fraunce	france
friendlie	friendly
frier	friar
friers	friars
frightned	frighted
frolick	frolic
frolicksome	frolicsome
frome	from
fronde	frond
fronte	front
fructifie	fructify
fryar	friar
fryars	friars
fryers	friars
ftorie	story
ful	full
fulfill	fulfil
fulfillment	fulfilment
fulfills	fulfils
fulness	fullness
funneled	funnelled
funneling	funnelling
fupplie	supply
furrs	furs
furth	forth
fye	fie
gage	gauge
gaged	gauged
gages	gauges
gaging	gauging
galantry	gallantry
gallick	gallic
gallies	galleys
gally	galley
gamboled	gambolled
gamboling	gambolling
gard	guard
garde	guard
gardiner	gardener
gardner	gardener
garison	garrison
garlick	garlic
gasses	gases
gat	got
gayety	gaiety
gayly	gaily
generall	general
geniusses	geniuses
geoffry	geoffrey
geographie	geography
georgicks	georgics
gett	get
gigantick	gigantic
gingle	jingle
gipsey	gypsy
gipsy	gypsy
glamor	glamour
glas	glass
glasse	glass
glocester	gloucester
glorifie	glorify
gloster	gloucester
gluing	glueing
godlie	godly
goe	go
goiter	goitre
goiters	goitres
golde	gold
gon	gone
gonorrhea	gonorrhoea
goode	good
gothick	gothic
gott	got
goverment	government
governante	governant
governour	governor
governours	governors
graecian	grecian
gram	gramme
grams	grammes
grashopper	grasshopper
grashoppers	grasshoppers
gratifie	gratify
graunt	grant
graveled	gravelled
gravitie	gravity
gray	grey
grayed	greyed
graying	greying
grayish	greyish
grayness	greyness
grays	greys
greate	great
greatlie	greatly
gret	great
grete	great
griesly	grisly
griffin	gryphon
griffins	gryphons
groins	groynes
grosly	grossly
grosse	gross
grottos	grottoes
grounde	ground
groupe	group
groupes	groups
groveled	grovelled
groveling	grovelling
groyne	groin
grueling	gruelling
gruelingly	gruellingly
gude	good
guelderland	gelderland
guiltie	guilty
gulielmi	guglielmi
gulph	gulf
gulphs	gulfs
gynecological	gynaecological
gynecologist	gynaecologist
gynecologists	gynaecologists
gynecology	gynaecology
gypsey	gypsy
gypsies	gipsies
h.m.s	h.m.s.
halfe	half
halle	hall
haly	holy
hamburgh	hamburg
hande	hand
handes	hands
handie	handy
handsom	handsome
handsomly	handsomely
hapned	happened
harbor	harbour
harbored	harboured
harboring	harbouring
harbors	harbours
hardned	hardened
harkye	harkee
harmonie	harmony
harrangue	harangue
harrangued	harangued
harrassed	harassed
hastie	hasty
haue	have
haveing	having
havock	havoc
hawke	hawk
hawling	hauling
hazle	hazel
headach	headache
heare	hear
heark	hark
hearkee	harkee
heartie	hearty
heavenlie	heavenly
heavie	heavy
hed	head
heighth	height
heightned	heightened
helpe	help
helpt	helped
hematological	haematological
hematologist	haematologist
hematologists	haematologists
hematology	haematology
hemoglobin	haemoglobin
hemophilia	haemophilia
hemophiliac	haemophiliac
hemophiliacs	haemophiliacs
hemorrhage	haemorrhage
hemorrhaged	haemorrhaged
hemorrhages	haemorrhages
hemorrhaging	haemorrhaging
hemorrhoids	haemorrhoids
her's	hers
heresie	heresy
heretick	heretic
hereticks	heretics
heroe	hero
heroe's	hero's
heroick	heroic
heroicks	heroics
herse	hearse
herselfe	herself
hieroglyphicks	hieroglyphics
hiftorie	history
himsel	himself
himselfe	himself
hinderance	hindrance
hinderances	hindrances
hindoos	hindus
hindred	hindered
hindring	hindering
historie	history
hobbie	hobby
hoftilitie	hostility
holde	hold
holden	held
hollinshed	holinshed
holyday	holiday
homeopath	homoeopath
homeopathic	homoeopathic
homeopaths	homoeopaths
homeopathy	homoeopathy
homewards	homeward
honestie	honesty
hongrie	hungry
honied	honeyed
honor	honour
honorable	honourable
honorably	honourably
honored	honoured
honoring	honouring
honors	honours
hooke	hook
horne	horn
horrida	horridam
horrour	horror
horrours	horrors
hoste	host
hostes	hosts
hould	hold
hous	house
houshold	household
hugonots	huguenots
humanitie	humanity
humilitie	humility
humor	humour
humored	humoured
humoring	humouring
humorless	humourless
humors	humours
humourous	humorous
hundreth	hundredth
husht	hushed
hussey	hussy
hye	hie
hym	him
hypocrifie	hypocrisy
hypocrisie	hypocrisy
hys	his
i.e	i.e.
ideot	idiot
ideots	idiots
idolatrie	idolatry
ile	isle
iles	isles
imagin	imagine
imbark	embark
imbarked	embarked
imbarking	embarking
imbarks	embarks
imbecillity	imbecility
imbitter	embitter
imbittered	embittered
imbrown	embrown
imbrowned	embrowned
imder	under
immediatlie	immediately
immediatly	immediately
impaneled	impanelled
impaneling	impanelling
impassible	impassable
impells	impels
imperiled	imperilled
imperiling	imperilling
impietie	impiety
implicitely	implicitly
imploy	employ
imployed	employed
imploying	employing
imployment	employment
imployments	employments
imploys	employs
impolitick	impolitic
impower	empower
impowered	empowered
imprest	impressed
impurpled	empurpled
inchanted	enchanted
inchanting	enchanting
inchantment	enchantment
inchantments	enchantments
incircled	encircled
incircling	encircling
inclose	enclose
inclosed	enclosed
incloses	encloses
inclosing	enclosing
inclosure	enclosure
inclosures	enclosures
incompleat	incomplete
incontestible	incontestable
inconveniencies	inconveniences
incourage	encourage
incouragement	encouragement
incroach	encroach
incroaching	encroaching
incroachment	encroachment
incumber	encumber
incumbered	encumbered
incumbering	encumbering
incumbers	encumbers
incumbrance	encumbrance
incumbrances	encumbrances
independance	independence
independant	independent
indispensible	indispensable
indispensibly	indispensably
indorse	endorse
indorsed	endorsed
indorsee	endorsee
indorsees	endorsees
indorsement	endorsement
indorser	endorser
indorser's	endorser's
indorsers	endorsers
indorses	endorses
indorsing	endorsing
indue	endue
indued	endued
indues	endues
induftrie	industry
induing	enduing
indure	endure
industrie	industry
inexcuseable	inexcusable
infancie	infancy
inferiour	inferior
inflection	inflexion
inflections	inflexions
inflid	inflict
infliet	inflict
inflieted	inflicted
inflinct	instinct
inflituted	instituted
inflitution	institution
inflitutions	institutions
infold	enfold
inforce	enforce
inforced	enforced
inforces	enforces
inforcing	enforcing
informe	inform
ingage	engage
ingaged	engaged
ingaging	engaging
ingulph	engulf
ingulphed	engulfed
iniquitie	iniquity
initialed	initialled
initialing	initialling
injoin	enjoin
injoined	enjoined
injoins	enjoins
injur	injure
inlarge	enlarge
inlarged	enlarged
inlarges	enlarges
inlarging	enlarging
inlift	enlist
inlifted	enlisted
inlifting	enlisting
inlist	enlist
inlisted	enlisted
inlluence	influence
innervate	enervate
innervated	enervated
innervation	enervation
innes	inns
innocence	innocence
innocencie	innocence
innocency	innocence
innocente	innocent
inrich	enrich
inriched	enriched
inriches	enriches
inriching	enriching
inrolled	enrolled
inseperable	inseparable
inshrine	enshrine
inshrined	enshrined
insnare	ensnare
insolencies	insolences
install	instal
installment	instalment
installments	instalments
installs	instals
instill	instil
instills	instils
intangled	entangled
intermixt	intermixed
intice	entice
inticing	enticing
intire	entire
intirely	entirely
intitle	entitle
intitled	entitled
intitles	entitles
intituled	entitled
intollerable	intolerable
intrails	entrails
intreat	entreat
intreated	entreated
intreaties	entreaties
intreating	entreating
intreaty	entreaty
intrench	entrench
intrenched	entrenched
intrenches	entrenches
intrenching	entrenching
intrenchment	entrenchment
intrinfick	intrinsic
intrinsick	intrinsic
intrusted	entrusted
intrusting	entrusting
inuendo	innuendo
invenom	envenom
invenomed	envenomed
irreconcileable	irreconcilable
irresistable	irresistible
irresistably	irresistible
ismael	ishmael
jackall	jackal
jail	gaol
jailbird	gaolbird
jailbirds	gaolbirds
jailbreak	gaolbreak
jailbreaks	gaolbreaks
jailed	gaoled
jailer	gaoler
jailers	gaolers
jailing	gaoling
jails	gaols
japonese	japanese
jayl	gaol
jealoufie	jealousy
jealousie	jealousy
jeweled	jewelled
jeweler	jeweller
jewelers	jewellers
jewell	jewel
jewelry	jewellery
jigg	jig
joannes	johannes
joannis	johannis
jobb	job
johanne	johan
journies	journeys
joye	joy
joyn	join
joyned	joined
joyning	joining
joyns	joins
judg	judge
judgment	judgement
junck	junk
juste	just
justifie	justify
kalendar	calendar
keene	keen
keepe	keep
kepe	keep
ketch	catch
kidnies	kidneys
kilogram	kilogramme
kilograms	kilogrammes
kilometer	kilometre
kilometers	kilometres
kinge	king
kist	kissed
kitchin	kitchen
kno	know
knowe	know
knowlege	knowledge
kyng	king
kynge	king
labeled	labelled
labeling	labelling
labor	labour
labore	labour
labored	laboured
laborer	labourer
laborers	labourers
laboring	labouring
labors	labours
lacedÃ¦mon	lacedaemon
lacedÃ¦monian	lacedaemonian
lacedÃ¦monians	lacedaemonians
lackluster	lacklustre
lacquey	lackey
lacqueys	lackeys
lacquies	lackeys
ladie	lady
lampe	lamp
landaff	llandaff
lande	land
landes	lands
landskip	landscape
landskips	landscapes
langour	languor
lanthorn	lantern
larum	alarm
latelie	lately
latere	later
latine	latin
laught	laughed
launce	lance
launcelot	lancelot
launces	lances
laureat	laureate
laureat's	laureate's
lawe	law
lawes	laws
lawfull	lawful
lawfullie	lawfully
lawrel	laurel
lawrels	laurels
layed	laid
leake	leak
leant	leaned
leaped	leapt
learnt	learned
leasure	leisure
legat	legate
legge	leg
leipsic	leipzig
lenth	length
lesse	less
lethargick	lethargic
lett	let
lette	let
lettres	letters
leud	lewd
leukemia	leukaemia
leve	leave
leveled	levelled
leveler	leveller
levelers	levellers
leveling	levelling
lewes	lews
ley	lay
libeled	libelled
libeling	libelling
libelous	libellous
librarie	library
licenced	licensed
licencing	licensing
license	licence
licenses	licences
lightening	lightning
likelyhood	likelihood
lillies	lilies
lilly	lily
limite	limit
limitted	limited
lingring	lingering
linnen	linen
liquour	liquor
liquours	liquors
listned	listened
listning	listening
liter	litre
liters	litres
lites	lights
litle	little
littel	little
litteral	literal
litterally	literally
ll.d	ll.d.
loaths	loathes
lodgment	lodgement
logick	logic
longe	long
looke	look
lookt	looked
lopt	lopped
lorde	lord
lordes	lords
louver	louvre
louvered	louvred
louvers	louvres
lowe	low
lowring	lowering
loyaltie	loyalty
lud	lord
lunatick	lunatic
lunaticks	lunatics
luster	lustre
lyable	liable
lyar	liar
lyars	liars
lyes	lies
lyfe	life
lyke	like
lyme	lime
lyon	lion
lyon's	lion's
lyrick	lyric
m.a	m.a.
m.d	m.d.
m.p	m.p.
mackarel	mackerel
madamoiselle	mademoiselle
madona	madonna
maestricht	maastricht
magick	magic
magnifick	magnific
magpye	magpie
mahomed	mohammed
mahometans	muslims
mahommed	mohammed
mahummad	mohammed
maie	may
maieftie	majesty
maintainance	maintenance
maister	master
majeftick	majestic
majeftie	majesty
majestick	majestic
majestie	majesty
mak	make
makeing	making
maladie	malady
malecontent	malcontent
malecontents	malcontents
mandarines	mandarins
maner	manner
manere	manner
maneuver	manoeuvre
maneuverability	manoeuvrability
maneuverable	manoeuvrable
maneuvered	manoeuvred
maneuvering	manoeuvring
maneuverings	manoeuvrings
maneuvers	manoeuvres
manie	many
manifestlie	manifestly
manne	man
mannor	manor
manour	manor
marche	march
marcht	marched
mareschal	marshal
margent	margin
mariage	marriage
marke	mark
marle	marl
marque	mark
marquiss	marquis
marr	mar
marryed	married
marshaled	marshalled
marshaling	marshalling
marshall	marshal
marte	mart
marveled	marvelled
marveling	marvelling
marvelous	marvellous
marvelously	marvellously
masse	mass
mathematicks	mathematics
mathew	matthew
mathews	matthews
mattins	matins
mattrass	mattress
maxime	maxim
maye	may
mayne	main
mayst	mayest
md	m.d.
meade	mead
meager	meagre
meandring	meandering
meanes	means
mechanick	mechanic
mechanicks	mechanics
medieval	mediaeval
medling	meddling
medly	medley
mee	me
meer	mere
meerly	merely
melancholly	melancholy
melvil	melville
memoires	memoirs
memorandums	memoranda
memorie	memory
mene	mean
merchandize	merchandise
mercie	mercy
mery	merry
messuage	message
metaphysicks	metaphysics
meteorologie	meteorology
meter	metre
meters	metres
micrometer	micrometre
micrometers	micrometres
midwifry	midwifery
mie	my
miferie	misery
mightie	mighty
milligram	milligramme
milligrams	milligrammes
milliliter	millilitre
milliliters	millilitres
millimeter	millimetre
millimeters	millimetres
mimick	mimic
mimickry	mimicry
mimicks	mimics
minde	mind
minibusses	minibuses
ministrie	minstry
ministring	ministering
mirrour	mirror
misbehavior	misbehaviour
misdemeanor	misdemeanour
misdemeanors	misdemeanours
mistery	mystery
mistick	mystic
miter	mitre
miters	mitres
mixt	mixed
modeftie	modestie
modeled	modelled
modeler	modeller
modelers	modellers
modeling	modelling
modestie	modesty
mold	mould
molded	moulded
molder	moulder
moldered	mouldered
moldering	mouldering
molders	moulders
moldier	mouldier
moldiest	mouldiest
molding	moulding
moldings	mouldings
molds	moulds
moldy	mouldy
molt	moult
molted	moulted
molten	melted
molting	moulting
molts	moults
molyneux	molineux
monarchie	monarchy
monarque	monarch
monastick	monastic
monastry	monastery
moneth	month
mongst	amongst
monied	moneyed
monies	moneys
monkies	monkeys
monolog	monologue
monologs	monologues
mony	money
morne	morn
mortifie	mortify
moscheto	mosquito
moschetoes	mosquitoes
moste	most
mought	might
mouldring	mouldering
moveable	movable
moveables	movables
moyle	moil
mp	m.p.
multicolored	multicoloured
murmure	murmur
murther	murder
murthered	murdered
murtherer	murderer
murtherers	murderers
murthering	murdering
murthers	murders
musick	music
musick's	music's
musquito	mosquito
musquitoes	mosquitoes
mussulman	musulman
mussulmanss	mohammedan
mustache	moustache
mustached	moustached
mustaches	moustaches
mustachioed	moustachioed
myn	mine
mynde	mind
myne	mine
mystick	mystic
n.b	n.b.
n.e	northeast
n.w	northwest
nathless	natheless
naught	nought
ne	northeast
neceffarie	necessary
necessarie	necessary
necessitie	necessity
neer	near
negociate	negotiate
negociated	negotiated
negociating	negotiating
negociation	negotiation
negociations	negotiations
negociator	negotiator
neice	niece
neighbor	neighbour
neighborhood	neighbourhood
neighborhoods	neighbourhoods
neighboring	neighbouring
neighborliness	neighbourliness
neighborly	neighbourly
neighbors	neighbours
nett	net
newbery	newberry
nich	niche
nipt	nipped
nobilitie	nobility
noe	no
nonsence	nonsense
notifie	notify
nowe	now
numbred	numbered
nunquam	numquam
nurst	nursed
nusance	nuisance
nutt	nut
nw	northwest
o'erflowing	overflowing
oates	oats
obeysance	obeisance
occured	occurred
odly	oddly
odor	odour
odorless	odourless
odors	odours
oeconomical	economical
oeconomy	economy
offense	offence
offenses	offences
oftner	oftener
oker	ochre
olde	old
omelet	omelette
omelets	omelettes
onely	only
onlie	only
ony	any
opake	opaque
ope	open
openlie	openly
opes	opens
opportunitie	opportunity
opprest	oppressed
opticks	optics
oratione	oration
orbe	orb
ordre	order
ordred	ordered
orientale	oriental
orthopedic	orthopaedic
orthopedics	orthopaedics
othe	oath
ould	old
ound	owned
ourself	ourselves
outmaneuver	outmanoeuvre
outmaneuvered	outmanoeuvred
outmaneuvering	outmanoeuvring
outmaneuvers	outmanoeuvres
outragious	outrageous
outstript	outstripped
overborn	overborne
overburthened	overburdened
overlie	overly
owne	own
oyl	oil
p.m	p.m.
p.s	p.s.
p.s	p.s.
pacifick	pacific
pacquets	packets
paire	pair
pajama	pyjama
pajamas	pyjamas
paket	packet
paleolithic	palaeolithic
paleontologist	palaeontologist
paleontologists	palaeontologists
paleontology	palaeontology
pallisadoes	palisades
panegyrick	panegyric
panegyricks	panegyrics
paneled	panelled
paneling	panelling
panelist	panellist
panelists	panellists
panick	panic
pannels	panels
papistrie	papistry
paradice	paradise
paralytick	paralytic
paralyze	paralyse
paralyzed	paralysed
paralyzes	paralyses
paralyzing	paralysing
parceled	parcelled
parceling	parcelling
parentes	parents
parlement	parliament
parlor	parlour
parlors	parlours
parly	parley
paroxism	paroxysm
partes	parts
particulary	particularly
partie	party
partizans	partisans
partlie	partly
passe	pass
pathetick	pathetic
patrimonie	patrimony
patriotick	patriotic
patrole	patrol
paultry	paltry
pavillion	pavilion
payed	paid
payne	pain
pearch	perch
pease	peas
pecock	peacock
pedaled	pedalled
pedaling	pedalling
pedantick	pedantic
pederast	paederast
pederasts	paederasts
pediatric	paediatric
pediatrician	paediatrician
pediatricians	paediatricians
pediatrics	paediatrics
pedophile	paedophile
pedophiles	paedophiles
pedophilia	paedophilia
peele	peel
peice	piece
peices	pieces
peine	pain
penciled	pencilled
penciling	pencilling
pennance	penance
peny	penny
perche	perch
pere	peer
perfeck	perfect
perfectlie	perfectly
perplext	perplexed
perriwig	periwig
perriwigs	periwigs
persidious	perfidious
persidy	perfidy
persone	person
personne	person
persue	pursue
persued	pursued
persume	presume
perswade	persuade
perswaded	persuaded
perswades	persuades
perswading	persuading
perswasion	persuasion
perswasions	persuasions
perswasive	persuasive
ph.d	ph.d
phaenomena	phenomena
phaenomenon	phenomenon
phantasie	fantasy
phantastic	fantastic
phantasy	fantasy
phantome	phantom
pharmacopeia	pharmacopoeia
pharmacopeias	pharmacopoeias
phebe	phoebe
phenix	phoenix
philologie	philology
philosophick	philosophic
philosophie	philosophy
phlegmatick	phlegmatic
phoenomena	phenomena
phrensy	frenzy
phrenzy	frenzy
physick	physic
physicks	physics
phÃ¦nomena	phenomena
phÅbus	phoebus
phÅnicia	phoenicia
phÅnicians	phoenicians
pickt	picked
pidgeon	pigeon
pidgeons	pigeons
pinacle	pinnacle
pindarick	pindaric
pistole	pistol
pitty	pity
plaine	plain
plaister	plaster
plaistered	plastered
plaistering	plastering
plaisters	plasters
platonick	platonic
platted	plaited
pleasaunce	pleasance
plein	plain
plow	plough
plowed	ploughed
plowing	ploughing
plowman	ploughman
plowmen	ploughmen
plows	ploughs
plowshare	ploughshare
plowshares	ploughshares
pluckt	plucked
plyant	pliant
plyed	plied
poefie	poesy
poesie	poesy
poete	poet
poetes	poets
poetick	poetic
poetrie	poetry
poictiers	poitiers
poize	poise
poized	poised
poizes	poises
policie	policy
politick	politic
politickly	politicly
politicks	politics
politique	politic
pondere	ponder
ponyard	poigniard
poole	pool
poore	poor
popt	popped
porte	port
portugueze	portuguese
posses	possess
possest	possessed
postcript	postscript
poste	post
posteritie	posterity
pouf	pouffe
poufs	pouffes
pourtray	portray
pourtrayed	portrayed
pourtraying	portraying
pourtrays	portrays
poyson	poison
practiced	practised
practices	practises
practicing	practising
practise	practice
praeternatural	preternatural
preceeded	preceded
preceeding	preceding
prefered	preferred
prefering	preferring
prefixt	prefixed
premisses	premises
presente	present
presidium	praesidium
presidiums	praesidiums
presse	press
prest	pressed
pretense	pretence
pretenses	pretences
prethee	prithee
pretious	precious
primeval	primaeval
princesse	princess
privie	privy
priviledge	privilege
priviledges	privileges
profest	professed
prognostick	prognostic
program	programme
programs	programmes
prolifick	prolific
prolog	prologue
prologs	prologues
propertie	property
prophanation	profanation
prophane	profane
prophanely	profanely
prophaneness	profaneness
prophesie	prophecy
prophesies	prophecies
prophetick	prophetic
propre	proper
propt	propped
prosessed	processed
prosession	procession
prosperitie	prosperity
provencial	provincial
prythee	prithee
prÃ¦ternatural	preternatural
prÃ¦torian	praetorian
ps	p.s.
psychoanalyze	psychoanalyse
psychoanalyzed	psychoanalysed
psychoanalyzes	psychoanalyses
psychoanalyzing	psychoanalysing
ptolomy	ptolemy
publica	publicam
publick	public
publickly	publicly
publique	public
pummel	pummelled
pummeled	pummelling
purchas	purchase
puritie	purity
putt	put
pye	pie
pyes	pies
pyle	pile
pyrates	pirates
pzazz	pizzazz
quadrupedes	quadrupeds
qualifie	qualify
qualitie	quality
quantitie	quantity
quarreled	quarrelled
quarreling	quarrelling
queene	queen
quene	queen
quickning	quickening
quippe	quip
quire	choir
r.a	r.a.
rabbins	rabbis
railery	raillery
rallyed	rallied
rancor	rancour
rase	raze
ratling	rattling
raveled	ravelled
raveling	ravelling
rayment	raiment
reade	read
readie	ready
reafonabie	reasonable
realme	realm
rebelles	rebels
recal	recall
recals	recalls
recompence	recompense
recompenced	recompensed
recompences	recompenses
reconnoiter	reconnoitre
reconnoitered	reconnoitred
reconnoitering	reconnoitring
reconnoiters	reconnoitres
rectifie	rectify
redrest	redressed
referre	refer
reflexion	reflection
reflexions	reflections
refueled	refuelled
refueling	refuelling
registred	registered
regreted	regretted
rejoyce	rejoice
rejoyced	rejoiced
rejoycing	rejoicing
relick	relic
relicks	relics
relie	rely
religione	religion
relique	relic
reliques	relics
remedie	remedy
remembred	remembered
remembring	remembering
remodeled	remodelled
remodeling	remodelling
remold	remould
remolded	remoulded
remolding	remoulding
remolds	remoulds
removeable	removable
rendre	render
rendred	rendered
rendring	rendering
repell	repel
replyed	replied
represt	repressed
republick	republic
republicks	republics
resined	resigned
reste	rest
reveled	revelled
reveler	reveller
revelers	revellers
reveling	revelling
revery	reverie
rhetorick	rhetoric
rhiming	rhyming
riband	ribbon
ribands	ribbons
ribband	ribbon
ribbands	ribbons
riche	rich
richlieu	richelieu
rigor	rigour
rigors	rigours
rime	rhyme
rimes	rhymes
risqued	risked
rivaled	rivalled
rivaling	rivalling
rivalship	rivalry
rivetted	riveted
rolle	roll
romantick	romantic
rooke	rook
roome	room
roseat	roseate
rosie	rosy
rosse	rose
rouze	rouse
rouzed	roused
rowe	row
rowl	roll
rowling	rolling
royale	royal
rubrick	rubric
ruine	ruin
ruines	ruins
rumor	rumour
rumored	rumoured
rumors	rumours
rustick	rustic
rusticks	rustics
ryder	rider
s'death	sdeath
s.e	southeast
s.w	southwest
saber	sabre
sabers	sabres
saide	said
saie	say
sailers	sailors
sainte	saint
salique	salic
sall	shall
sallad	salad
sallads	salads
sallary	salary
saltpeter	saltpetre
sarcastick	sarcastic
sarvant	servant
sate	sat
satisfie	satisfy
satisfyed	satisfied
satten	satin
sattin	satin
sattins	satins
satyre	satire
satyrical	satirical
satyrist	satirist
satyrists	satirists
saue	save
savior	saviour
saviors	saviours
savor	savour
savored	savoured
savories	savouries
savoring	savouring
savors	savours
savory	savoury
sawcy	saucy
sawe	saw
sayd	said
saye	say
sayst	sayest
scape	escape
scapes	escapes
scepter	sceptre
sceptered	sceptred
scepters	sceptres
schismaticks	schismatics
scholastick	scholastic
scientifick	scientific
scissars	scissors
scite	site
scituation	situation
scotish	scottish
scribler	scribbler
scriblers	scribblers
scribling	scribbling
scrophulous	scrofulous
sculk	skulk
sculking	skulking
sculks	skulks
se	southeast
seale	seal
secresy	secrecy
securitie	security
seeke	seek
seeme	seem
seene	seen
seenes	scenes
seige	siege
seised	seized
selden	seldom
selfe	self
sence	sense
sences	senses
sene	seen
sensless	senseless
sentimentalitie	sentimentality
seperate	separate
seperated	separated
sepulcher	sepulchre
sepulchers	sepulchres
sequestred	sequestered
seraphick	seraphic
serjeant	sergeant
serjeant's	sergeant's
serjeants	sergeants
sermone	sermon
serv	serve
servent	servant
sese	seize
setled	settled
setling	settling
sett	set
sette	set
setts	sets
severall	several
sha'n't	shan't
shakespear	shakespeare
shakespear's	shakespeare's
shakspear	shakespeare
shakspeare	shakespeare
shakspeare's	shakespeare's
shal	shall
shamefullie	shamefully
sharpe	sharp
shee	she
shew	show
shewe	show
shewed	showed
sheweth	showeth
shewing	showing
shewn	shown
shews	shows
shewy	showy
shipwrack	shipwreck
shoar	shore
shortlie	shortly
shortned	shortened
shoud	should
shouldest	shouldst
shoveled	shovelled
shoveling	shovelling
shriveled	shrivelled
shriveling	shrivelling
shrowd	shroud
shrowded	shrouded
shuld	should
sidelity	fidelity
sierce	fierce
sieze	seize
signaled	signalled
signaling	signalling
signe	sign
signifie	signify
silvan	sylvan
similies	similes
siphon	syphon
siphoned	syphoned
siphoning	syphoning
siphons	syphons
sirname	surname
sirnamed	surnamed
sirnames	surnames
sixt	sixth
skeptic	sceptic
skeptical	sceptical
skeptically	sceptically
skepticism	scepticism
skeptics	sceptics
skie	sky
skillful	skilful
skreen	screen
skreens	screens
slipt	slipped
smelt	smelled
smoak	smoke
smoaked	smoked
smoaking	smoking
smoaks	smokes
smoaky	smoky
smolder	smoulder
smoldered	smouldered
smoldering	smouldering
smolders	smoulders
smoothe	smooth
snapt	snapped
snatcht	snatched
sniveled	snivelled
sniveling	snivelling
snorkeled	snorkelled
snorkeling	snorkelling
snowplow	snowplough
soe	so
softned	softened
softning	softening
solem	solemn
solemnitie	solemnity
sollicit	solicit
sollicitation	solicitation
sollicitations	solicitations
sollicite	solicit
sollicited	solicited
solliciting	soliciting
sollicitor	solicitor
sollicitous	solicitous
sollicits	solicits
sollicitude	solicitude
som	some
somber	sombre
sommes	sums
sonne	son
sonnes	sons
soo	so
soone	soon
sorce	source
sorte	sort
sortes	sorts
sorth	forth
sould	should
souldiers	soldiers
soule	soul
soules	souls
soveraign	sovereign
sowre	sour
spanifh	spanish
speake	speak
specifick	specific
specter	spectre
specters	spectres
speedie	speedy
speke	speak
spelt	spelled
spight	spite
spilt	spilled
spiraled	spiralled
spiraling	spiralling
splendor	splendour
splendors	splendours
splenetick	splenetic
springes	springs
sprit	spirit
spunge	sponge
spunging	sponging
spungy	spongy
squirreled	squirrelled
squirreling	squirrelling
staines	stains
stampt	stamped
stanch	staunch
sted	stead
steddy	steady
stedfast	steadfast
stedfastly	steadfastly
stedfastness	steadfastness
stenciled	stencilled
stenciling	stencilling
stept	stepped
steril	sterile
stil	still
stile	style
stiled	styled
stiles	styles
stiling	styling
stilness	stillness
stoick	stoic
stoicks	stoics
stollen	stolen
stoln	stolen
stoped	stopped
stopt	stopped
storey	story
storeys	stories
stowe	stow
stradling	straddling
straiten	straighten
straitened	straightened
straitway	straightway
streight	straight
streights	straights
strengthned	strengthened
strengthning	strengthening
stretcht	stretched
stript	stripped
stroak	stroke
stroaked	stroked
stroaking	stroking
stroaks	strokes
stroling	strolling
strugling	struggling
strype	stripe
studie	study
stuft	stuffed
subsistance	subsistence
subtil	subtle
subtile	subtle
subtilties	subtleties
subtilty	subtlety
succeded	succeeded
succor	succour
succored	succoured
succoring	succouring
succors	succours
suche	such
suddain	sudden
sulfate	sulphate
sulfates	sulphates
sulfide	sulphide
sulfides	sulphides
sulfur	sulphur
sulfurous	sulphurous
summ	sum
summe	sum
sundrie	sundry
sunne	sun
superiour	superior
superiours	superiors
supplie	supply
supplyed	supplied
supprest	suppressed
supream	supreme
surpast	surpassed
surprize	surprise
surprized	surprised
surprizes	surprises
surprizing	surprising
surprizingly	surprisingly
surrendred	surrendered
suspence	suspense
sute	suit
sw	southwest
swiveled	swivelled
swiveling	swivelling
swolen	swollen
swoln	swollen
syde	side
sylvius	silvius
symetry	symmetry
sympathetick	sympathetic
syn	sin
syrens	sirens
systematick	systematic
takeing	taking
tasseled	tasselled
tast	taste
tawney	tawny
taylors	tailors
teaze	tease
teazed	teased
teazes	teases
teazing	teasing
technicolor	technicolour
teftifie	testify
teftimonie	testimony
teize	tease
teized	teased
teizing	teasing
telle	tell
tendre	tender
tenour	tenor
terme	term
termes	terms
terrifick	terrific
terrifie	terrify
terrour	terror
terrours	terrors
testifie	testify
thankfullie	thankfully
theater	theatre
theatergoer	theatregoer
theatergoers	theatregoers
theaters	theatres
thei	they
themistocles	themistocles
themselve	themselves
themseves	themselves
theologie	theology
ther	there
therefor	therefore
therfore	therefore
thes	these
thier	their
thinke	think
thir	their
thirtie	thirty
tho	though
tholouse	toulouse
thorne	thorn
thornie	thorny
thorow	thorough
thos	those
thre	three
threatned	threatened
threatning	threatening
threatnings	threatenings
thriftie	thrifty
thro	through
throughly	thoroughly
tht	that
thundring	thundering
tickell	tickle
til	till
timerous	timorous
tinie	tiny
tipsey	tipsy
tipt	tipped
tire	tyre
tires	tyres
tollerable	tolerable
tollerably	tolerably
tomarrow	tomorrow
tombe	tomb
ton	tonne
tons	tonnes
tooke	took
topick	topic
topicks	topics
topt	topped
torne	torn
tost	tossed
touche	touch
toucht	touched
toweled	towelled
toweling	towelling
towne	town
towring	towering
toxemia	toxaemia
traffick	traffic
tragedie	tragedy
tragick	tragic
tragicomick	tragicomic
traiterous	traitorous
traiterously	traitorously
tranquility	tranquillity
trapp	trap
trappe	trap
traveled	travelled
traveler	traveller
travelers	travellers
traveling	travelling
travelog	travelogue
travelogs	travelogues
traytor	traitor
traytor's	traitor's
traytors	traitors
treatie	treaty
trew	true
trewe	true
trialed	trialled
trialing	trialling
tricolor	tricolour
tricolors	tricolours
triffling	trifling
tripple	triple
tript	trip
tropicks	tropics
trowsers	trousers
tru	true
truelie	truly
truely	truly
trulie	truly
tryal	trial
tryals	trials
tryed	tried
tumor	tumour
tumors	tumours
tunneled	tunnelled
tunneling	tunnelling
turkies	turkeys
turky	turkey
turne	turn
turnep	turnip
turneps	turnips
tyber	tiber
tyber's	tiber's
tyde	tied
tydes	tides
tydings	tidings
tye	tie
tyed	tied
tyes	ties
tyger	tiger
tyger's	tiger's
tygers	tigers
tygress	tigress
tyme	time
tymes	times
tyrannick	tyrannic
tyrannie	tyranny
tythe	tithe
tythes	tithes
unbiased	unbiassed
unbyassed	unbiassed
uncontrolable	uncontrollable
uncontroulable	uncontrollable
uncontrouled	uncontrolled
uneasie	uneasy
unequaled	unequalled
unfavorable	unfavourable
unfavorably	unfavourably
unhappie	unhappy
univerfitie	university
universitie	university
unmixt	unmixed
unpolite	impolite
unraveled	unravelled
unraveling	unravelling
unrivaled	unrivalled
unsavory	unsavoury
untill	until
untrammeled	untrammelled
unweildy	unwieldy
unwholsome	unwholesome
unworthie	unworthy
utterlie	utterly
vaine	vain
vallies	valleys
valor	valour
vapor	vapour
vapors	vapours
venemous	venomous
veri	very
verie	very
verifie	verify
veritie	verity
vermillion	vermilion
vermine	vermin
vertu	virtue
vertue	virtue
vertues	virtues
vertuous	virtuous
vext	vexed
victorie	victory
videodisk	videodisc
videodisks	videodiscs
vigor	vigour
villanies	villainies
villanous	villainous
villany	villainy
villenage	villeinage
villian	villain
violante	violent
virtu	virtue
vitious	vicious
vivifie	vivify
vollies	volleys
voluntarie	voluntary
voluntiers	vounteers
vulgare	vulgar
vultur	vulture
vulturs	vultures
vye	vie
waggon	wagon
waggoner	wagoner
waggons	wagons
wal	wall
wandred	wandered
wandring	wandering
warr	war
warre	war
warriour	warrior
warriour's	warrior's
warriours	warriors
watercolor	watercolour
watercolors	watercolours
watling	wattling
watry	watery
weakned	weakened
weare	wear
wearie	weary
weaseled	weaselled
weaseling	weaselling
weightie	weighty
weild	wield
wel	well
welchman	welshman
welchmen	welshmen
weltring	weltering
westmorland	westmoreland
wharfs	wharves
whch	which
wher	where
whereever	wherever
whic	which
whiche	which
whimsey	whimsy
whipt	whipped
whoe	who
wholesom	wholesome
wholsom	wholesome
wholsome	wholesome
whome	whom
wich	which
wil	will
wilfully	wilfully
willes	wills
willinglie	willingly
winde	wind
wintry	wintery
wisdome	wisdom
wisht	wished
withall	withal
wittie	witty
wizzard	wizard
wliicli	which
woful	woeful
wonderfull	wonderful
wonderous	wondrous
wondred	wondered
wondring	wondering
wonne	won
woolen	woollen
woolens	woollens
woolies	woollies
wooll	wool
wooly	woolly
worde	word
wordes	words
worke	work
workes	works
worlde	world
worldlie	worldly
worne	worn
worshiped	worshipped
worshipers	worshippers
worshiping	worshipping
worthie	worthy
woud	would
wouldest	wouldst
wrapt	wrapped
writeing	writing
writen	written
wrongfully	wrongfully
wth	with
wull	will
wyfe	wife
wyll	will
wynne	win
wyse	wise
wyth	with
yeare	year
yeares	years
yearlie	yearly
yee	ye
yeild	yield
yere	year
yoak	yoke
yodeled	yodelled
yodeling	yodelling
yoghourt	yogurt
yoghurt	yogurt
yoghurts	yogurts
yong	young
yonge	young
younge	young
yow	you
Ã¦conomy	economy
Ã¦gean	aegean
Ã¦gis	aegis
Ã¦olian	aeolian
Ã¦olus	aeolus
Ã¦ra	era
Ã¦rie	eyrie
Ã¦ry	airy
Ã¦sculapius	aesculapius
Ã¦sthetic	aesthetic
Ã¦sthetical	aesthetic
Ã¦sthetick	aesthetic
Ã¦sthetics	aesthetics
Ã¦ternal	eternal
Ã¦ther	aether
Ã¦ther's	aether's
Ã¦thereal	aethereal
Ã¦therial	aethereal
Åconomy	economy
Ênion	union
